wfWVArchiveDataOnCrash	archive_data_on_crash	short	0
wfWVQuickBarPosition	quick_bar_position	bool	0
wfWVBarGripScroll	bar_grip_scroll	short	0
wfWVBrowserWidthLast	browser_width_last	short	0
wfWVCalcEng	calc_eng	short	0
wfWVDisableStarExpandTree	disable_star_expand_tree	short	0
wfWVHideCursorDistance	hide_cursor_distance	short	0
wfWVHideRibbonMenu	hide_ribbon	short	0
wfWVHierSensitiveFilter	hiersensitive_filter	short	0
wfWVKeepSignalSearchString	keep_signalsearchstring	short	0
wfWVLimitZoomRange	limit_zoom_range	short	0
wfWVLoadDataAtOpen	load_data_at_open	short	-1
wfWVPanelFSMargin	panel_fs_margin	short	0
wfWVPlotSignalBottomPanel	plotsig_bottompanel	short	0
wfWVRefCursorValueIndv	ref_cursor_value_indv	short	0
wfWVSensitiveFilter	sensitive_filter	short	0
wfWVShowConsole	show_console	short	0
wfWVShowCrossLabel	show_cross_label	short	0
wfWVShowYType	show_ytype	short	0
wfWVSmartHSort	smart_hsort	short	0
wfWVSnapInterp	snap_interp	short	0
wfWVSnapMarker	snap_marker	short	0
wfWVSNRIncFloorNoise	SNR_inc_floor_noise	short	0
wfWVSpiceInstCasesensitive	spice_inst_casesensitive	short	0
SpiceParmCaseSensitive	spice_parm_casesensitive	short	0
SpiceSmartSort	spice_smart_sort	short	0
SpiceSortSubcktCells	spice_sort_subckt_cells	short	0
wfWVSupportSubstrSearch	support_substr_search	short	0
wfWVSuppressEqnFuncCompletion	suppress_eqn_func_completion	short	0
wfWVDMDMScale	SX_DM_DMScale	short	0
wfWVSXDMResultPanelScale	SX_DM_ResultPanelScale	short	0
wfWVQtFileDialog	use_qtfsb	short	0
wfWVOkButtonAutoCenter	okbtn_autocenter	short	0
wfWVWdfFilter	wdf_filter	short	0
wfWVGuiColor	gui_color	short	0
wfWVGroupDisplayOrder	group_display_order	short	0
wfWVSignalFilterOption	signal_filter_option	short	0
wfWVGridBrightness	grid_brightness	short	0
wfWVSpiceNetListErc	spice_netlist_erc	short	0
wfWVCdsLinkPlotMode	cds_link_plot_mode	short	0
wfWVLogicStyleDefault	logic_style_default	short	0
wfWVLeftButtonAction	left_button_action	short	0
wfWVInitXYMode	init_xy_mode	short	0
wfWVDefaultACStack	def_ac_stack	short	0
wfWVDefaultACYType	def_acy_type	short	0
wfWVDefaultTranXType	def_trx_type	short	0
wfWVDefaultTranYType	def_try_type	short	0
wfWVSignalDnDMode	signal_dnd_mode	short	0
wfWVSignalMode	signal_mode	short	0
wfWVEnablePanelSelection	enable_panel_selection	short	0
wfWVDisableAutocopyClipBoard	disable_autocopy_clipboard	short	0
wfWVSupressDeleteConfirm	delete_confirm	short	0
wfWVExitConfirm	exit_confirm	short	0
wfWVReloadConfirm	reload_confirm	short	0
wfWVDisableAutoStrip0	disable_autostrip0	short	0
wfWVPrivateColormap	private_colormap	short	0
wfWVA2DSignalThreshold	a2d_single_threshold	short	1
wfWVAutoConnectSplitFiles	auto_connect_split_files	short	1
wfWVClickMoveCursor	click_move_cursor	short	1
wfWVD2AFullExt	d2a_fullext	short	1
wfWVD2AXTol	d2a_xtol	short	1
wfWVDynamicFilter	dynamic_filter	short	1
wfWVLogicCursorSnap	logic_cursor_snap	short	1
wfWVLogicGlitchHighlight	logic_glitch_highlight	short	1
wfWVRealTimeScroll	real_time_scroll	short	1
wfWVShowEqnErrMsg	show_eqn_err_msg	short	1
SpiceCellIndexDepth	spice_cell_index_depth	short	1
wfWVIconizable	wv_iconizable	short	1
wfWVCdsLinkUpdateMode	cds_link_update_mode	short	1
wfWVGridDefault	grid_default	short	1
wfWVDefaultACXType	def_acx_type	short	1
wfWVDefaultFFTXScale	def_fft_xscale	short	1
wfWVDefaultFFTYScale	def_fft_yscale	short	2
wfWVCycleColorByPanel	cycle_color_by	short	2
wfWVYLabelWidth	y_label_width	short	30
wfWVHorizontalSliderStep	horizontal_slider_step	short	50
wfWVZoomInRatio	zoom_in_ratio	short	50
wfWVSignameWidth	signame_width	short	60
wfWVStartupMode	startup_mode	short	1
wfWVAxisFont	axis_font	int	0
wfWVLinesPerPanel	lines_per_panel	int	0
wfWVMaxVisiblePanels	max_visible_panels	int	0
PanelSpacing	panel_spacing	int	0
wfWVUnitScale	unit_scale	int	0
wfWVUserColors	user_colors	int	0
wfWVIncludeSubSig	include_sub_sig	int	0
wfWVTabPos	waveview_TabPos	int	0
wfWVWaveViewBackground	waveview_background	int	0
wfWVGuiFont	gui_font	int	0
wfWVXaxisGridExp	xaxis_grid_exp	int	0
wfWVXaxisGridInc	xaxis_grid_inc	int	0
wfWVYaxisGridExp	yaxis_grid_exp	int	0
wfWVYaxisGridInc	yaxis_grid_inc	int	0
wfWVY2axisGridExp	y2axis_grid_exp	int	0
wfWVY2axisGridInc	y2axis_grid_inc	int	0
wfWVAnalogPanelHeight	analog_panel_height	int	120
wfWVBrowserWidth	browser_width	int	250
wfWVDefaultHistogramBinSize	default_hist_binsize	int	10
wfWVDefaultPanelsPerRow	default_panels_perrow	int	4
wfWVMaxLogSpan	max_log_span	int	25
wfWVMinPanelHeight	min_panel_height	int	20
wfWVHorzPanelHeight	horz_panel_height	int	80
wfWVLogicPanelHeight	logic_panel_height	int	24
wfWVPrecisionDigits	precision_digits	int	3
wfWVReaderTopHierThreshold	read_top_hier_threshold	double	   5.000E+00
wfWVReplayDelay	replay_delay	int	1
wfWVAddTopLevelForFsdb	add_toplevel_for_fsdb	bool	0
wfWVAliasSignalNameOnly	alias_signal_name_only	bool	0
wfWVAutoXExtend	auto_x_extend	bool	0
wfWVButtonAddHCursor	btn_add_hcursor	bool	0
wfWVBusDiffColor	bus_diff_color	bool	0
wfWVCaseSensitiveTr0	case_sens_tr0	bool	0
wfWVConvertSToYZ	convert_s_to_yz	bool	0
wfWVDefaultHistogramSingle	default_hist_one	bool	0
wfWVDisableReloadWdfConfirm	disable_reload_wdf_confirm	bool	0
wfWVDisableUpdateEquation	disable_update_equation	bool	0
wfWVDisableUpdateSignal	disable_update_signal	bool	0
wfWVEnableMulClickItems	enable_mul_click_items	bool	0
wfWVExtendWaveform	extend_waveform	bool	0
wfWVFilterByXRange	filter_byxrange	bool	0
wfWVHidePanelDiv	hide_panel_div	bool	0
wfWVLockColor	lock_color	bool	0
wfWVAutoSwitchHorz	auto_switch_horz	bool	0
wfWVLoopLineStylesSweep	loop_linestyles_sweep	bool	0
wfWVPanelModeOnly	panel_mode_only	bool	0
wfWVRemoveDupSig	remove_dupsig	bool	0
wfWVSameColorSweep	same_color_sweep	bool	0
wfWVShowInfData	show_inf_data	bool	0
wfWVShowMPPrefix	show_MP_prefix	bool	0
wfWVShowSMButton	show_SM_button	bool	0
wfWVAutoYAxes	auto_y_axes	bool	0
wfWVAutoYWidth	auto_y_width	bool	0
wfWVSignalNamePopup	signame_popup	bool	0
wfWVTraceParmPopup	trace_parm_popup	bool	0
wfWVSwitchMouseButton	switch_mouse_button	bool	0
wfWVThickLine	thick_line	bool	0
wfWVAdeAppendReplace	use_ade_append_replace	bool	0
UseHspiceini	use_hspiceini	bool	0
wfWVUseLittleEndian	use_little_endian	bool	0
wfWVUseSnn	use_snn	bool	0
wfWVUseLeafName	use_leaf_name	bool	0
wfWVUserFixedYRange	user_fixed_yrange	bool	0
wfWVSignalNameAlign	signame_align	bool	0
wfWVSignalFont	signal_font	bool	0
wfWVSigNameSpacing	signame_spacing	bool	0
wfWVSignalPath	signal_path	bool	0
wfWVFastVncMode	fast_vnc_mode	bool	0
wfWVPlotSinglePointSweepOn2D	plot_single_point_sweep_on_2d	bool	0
wfWVSyncEnqBuilder	sync_eqnbuilder	bool	0
wfWVShowPanelMode	show_panel_mode	bool	0
wfWVXprobingColorSchem	x-probing_color_schem	bool	0
wfWVWhiteLabelColor	white_label_color	bool	0
wfWVUseCCKeyBindings	use_cc_keybindings	bool	0
wfWVAliasBracket	alias_bracket	bool	1
wfWVAutoXExtendDig	auto_x_extend_dig	bool	1
wfWVClampACPhase	clamp_ac_phase	bool	1
wfWVEnableWVHighlight	enable_wv_highlight	bool	1
wfWVFlattenSegs	flatten_segs	bool	1
wfWVFlattenSignalPointSweep	flatten_single_point_sweep	bool	1
wfWVLineThickness	line_thickness	bool	1
wfWVLogicRealPwcFsdb	logic_real_pwc_fsdb	bool	1
wfWVNotShowVHDLPorcess	not_show_vhdl_processes	bool	1
wfWVReadTopHier	read_top_hier	bool	1
wfWVSyncAlias	sync_alias	bool	1
wfWVAdjustSmallYRange	adjust_small_y_range	bool	1
wfWVStackAutoFit	stack_auto_fit	bool	1
wfWVSweepExpand	sweep_expand	bool	1
wfWVXAxisAutoGrid	xaxis_auto_grid	bool	1
wfWVYAxisAutoGrid	yaxis_auto_grid	bool	1
wfWVY2AxisAutoGrid	y2axis_auto_grid	bool	1
wfWVSignalName	signal_name	bool	3
wfWVD2ALowValue	d2a_low_value	float	   0.000E+00
wfWVDMLowLogic	dm_low_logic	float	   0.000E+00
wfWVD2AFallSlew	d2a_fall_slew	float	   1.000E-11
wfWVD2ARiseSlew	d2a_rise_slew	float	   1.000E-11
LintMinMosLength	lint_min_mos_length	float	   1.000E-08
LintMinMosWidth	lint_min_mos_width	float	   1.000E-08
LintMinResistance	lint_min_resistance	float	   1.000E-05
LintMaxCapcitance	lint_max_capacitance	float	   1.000E-03
LintMaxMosLegnth	lint_max_mos_length	float	   1.000E-02
LintMaxMosWidth	lint_max_mos_width	float	   1.000E-02
wfWVA2DLowThreshold	a2d_low_threshold	float	   1.000E+00
wfWVA2DCenterThreshold	a2d_center_threshold	float	   2.500E+00
wfWVD2AHighValue	d2a_high_value	float	   3.300E+00
wfWVDMHighLogic	dm_high_logic	float	   3.300E+00
wfWVA2DHighThreshold	a2d_high_threshold	float	   4.000E+00
wfWVDMLowMargin	dm_low_margin	float	   1.000E+01
wfWVSmithChartCharImpedance	smith_char_impedance	float	   5.000E+01
wfWVDMHighMargin	dm_high_margin	float	   9.000E+01
wfWVIMin	imin	double	   0.000E+00
wfWVVMin	vmin	double	   0.000E+00
wfWVVMax	vmax	double	   3.300E+00
wfWVInfValue	inf_value	double	   1.000E+50
wfWVIMax	imax	double	   1.000E-03
wfWVXaxisGridStart	xaxis_grid_start	double	   0.000E+00
wfWVXaxisGridStep	xaxis_grid_step	double	   0.000E+00
wfWVYaxisGridStart	yaxis_grid_start	double	   0.000E+00
wfWVYaxisGridStep	yaxis_grid_step	double	   0.000E+00
wfWVY2axisGridStart	y2axis_grid_start	double	   0.000E+00
wfWVY2axisGridStep	y2axis_grid_step	double	   0.000E+00
wfWVPrintTitle	print_title	string	(null)
wfWVPrinterDevice	printer_device	string	(null)
wfWVPrintCommand	print_command	string	(null)
wfWVUserRGB	user_rgb	string	(null)
wfWVLintSuppressList	lint_suppress_list	string	(null)
wfWVWdfFsbFilter	wdf_fsb_filter	int	(null)
wfWVSpiceFSBFilter	spice_fsb_filter	int	(null)
wfWVExportNotation	export_notation	int	1
wfWVSimplifiedRmsCalc	simplified_rms_calc	int	0
